11
***********
*g*       *
* ***** * *
*   *     *
*** * * * *
* *   *   *
* * * *   *
*       * *
* *** * * *
*       * s
***********
